12 12 12 12 12 12 12 12 12 12 12 12 12 12 12 12 12 12 12 12 12 12 12 12 12 12 12 12 12 12 12 12 12 12 12 12 12 12 12 12 12 12 12 12 12 12 12 12 12 12
12 12 12 12 12 12 12 12 12 12 12 12 12 12 12 12 12 12 12 12 12 12 12 12 12 12 12 12 12 12 12 12 12 12 12 12 12 12 12 12 12 12 12 12 12 12 12 12 12 12
12 12 12 12 12 12 12 12 12 12 12 12 12 12 12 12 12 12 12 12 12 12 12 12 12 12 12 12 12 12 12 12 12 12 12 12 12 12 12 12 12 12 12 12 12 12 12 12 12 12
12 12 12 12 12 12 12 12 12 12 12 12 12 12 12 12 12 12 12 12 12 12 12 12 12 12 12 12 12 12 12 12 12 12 12 12 12 12 12 12 12 12 12 12 12 12 12 12 12 12
12 12 12 12 12 12 12 12 12 12 12 12 12 12 12 12 12 12 12 12 12 12 12 12 12 12 12 12 12 12 12 12 12 12 12 12 12 12 12 12 12 12 12 12 12 12 12 12 12 12
12 12 12 12 12 12 12 12 12 12 12 12 12 12 12 29 12 12 12 12 12 29 12 12 12 12 12 12 12 12 12 12 12 12 12 12 12 12 12 12 12 12 12 12 12 12 12 12 12 12
12 12 12 12 12 29 12 12 12 12 12 12 12 12 12 12 12 29 12 12 12 12 12 12 12 12 12 12 12 12 12 12 12 12 12 12 12 29 12 12 12 12 12 12 12 12 12 12 12 12
12 12 12 12 12 12 12 29 12 12 12 12 12 12 12 12 12 12 12 12 12 12 12 12 12 12 12 12 12 12 12 12 12 12 12 12 12 12 12 12 12 12 29 12 12 12 12 12 12 12
12 12 12 12 12 12 12 12 28 20 20 20 20 20 20 20 20 20 20 20 20 20 20 20 20 20 20 20 20 20 20 20 20 20 20 20 20 20 20 20 20 27 12 12 12 12 12 12 12 12
12 12 12 12 12 12 12 12 24 10 10 10 10 10 10 10 10 10 10 10 10 10 10 10 14 10 10 14 14 14 14 14 10 14 14 14 10 10 10 10 14 23 12 12 12 12 12 12 12 12
12 12 12 12 12 12 12 12 24 10 14 10 14 14 14 14 14 14 14 14 14 14 14 10 10 10 10 10 10 10 10 16 10 14 14 10 10 10 14 10 14 23 12 12 12 29 12 12 12 12
12 12 12 12 12 12 12 29 24 10 14 14 14 14 10 10 10 10 10 16 10 10 14 14 14 14 14 14 14 14 14 10 14 14 14 10 14 14 14 10 14 23 12 12 12 12 12 12 12 12
12 12 12 12 12 12 12 12 24 10 10 14 14 14 10 11 11 11 11 11 11 11 11 11 11 11 11 11 11 11 14 10 14 14 14 10 14 10 14 14 14 23 12 12 12 12 12 12 12 12
12 12 12 12 12 12 12 12 24 14 10 10 10 14 10 11 18 17 17 17 17 17 17 17 17 17 17 17 19 11 14 10 14 14 10 10 10 10 10 14 14 23 29 12 12 12 12 12 12 12
12 12 12 12 12 12 12 12 24 14 10 14 10 14 10 11 23 12 12 28 20 20 20 20 20 27 12 12 24 11 16 10 14 14 10 14 10 14 10 10 14 23 12 12 29 12 12 12 12 12
12 12 12 12 12 12 12 29 24 14 10 14 10 14 10 11 23 12 12 24 13 13 13 13 13 23 12 12 24 11 10 10 14 14 10 14 14 14 14 14 14 23 12 12 12 12 12 12 12 12
12 12 12 29 12 12 12 12 24 14 10 14 10 14 10 11 23 29 12 24 13 13 13 13 13 23 29 12 24 11 10 14 14 14 10 14 10 10 10 10 10 23 12 29 12 12 12 12 12 12
12 12 12 12 12 12 12 12 24 14 10 14 10 14 10 11 23 12 12 24 13 13 13 13 13 23 12 12 24 11 10 14 10 10 10 10 10 10 14 14 10 23 12 12 12 12 12 12 12 12
12 12 12 12 12 12 12 12 24 14 16 14 10 14 10 11 23 12 29 26 19 13 13 13 18 25 12 12 24 11 10 14 10 14 14 14 14 14 14 10 10 23 12 12 12 12 12 12 12 12
12 12 12 12 29 12 12 12 24 14 10 14 10 14 10 11 23 12 12 12 26 19 13 18 25 12 12 29 24 11 10 14 10 14 10 10 10 10 10 10 10 23 12 12 12 12 12 12 12 12
12 12 12 12 12 12 12 12 24 14 10 14 10 14 10 11 21 20 20 20 20 22 13 21 20 20 20 20 22 11 16 14 10 14 10 14 14 14 14 14 10 23 12 29 12 12 12 12 12 12
12 12 12 12 12 12 12 12 24 10 10 14 10 14 10 11 11 11 11 11 11 11 13 11 11 11 11 11 11 11 10 14 10 14 10 10 10 14 10 14 10 23 12 12 12 12 12 12 12 12
12 12 12 12 12 12 12 12 24 10 14 14 10 14 10 10 10 10 10 10 11 11 13 11 11 16 10 10 10 10 10 14 10 14 10 14 10 10 10 14 10 23 12 12 12 12 12 12 12 12
12 12 12 12 12 12 12 12 24 10 14 10 10 14 14 14 14 14 14 10 11 11 13 11 11 10 14 14 14 14 14 14 10 14 10 14 14 14 14 14 10 23 12 12 12 12 12 12 12 12
12 12 12 12 12 12 12 29 24 10 14 10 14 10 14 14 14 10 14 10 11 11 13 11 11 10 14 10 10 10 10 10 10 14 10 10 10 10 10 14 10 23 12 12 12 29 12 12 12 12
12 12 12 12 12 12 12 12 24 10 14 10 14 10 10 10 10 10 14 10 13 13 13 13 13 16 14 10 14 14 14 14 14 14 10 10 14 14 10 14 10 23 12 12 12 12 12 12 12 12
12 12 12 12 12 12 12 12 24 10 14 10 14 14 14 14 14 10 14 14 13 13 13 13 13 10 14 10 10 10 10 14 10 14 14 14 14 10 10 14 10 23 12 12 12 12 12 12 12 12
12 12 12 12 12 12 12 12 24 10 14 16 14 10 10 10 14 10 10 14 13 13 13 13 13 16 14 14 14 14 10 14 10 14 14 10 14 10 14 14 10 23 12 12 12 12 12 12 12 12
12 12 12 12 12 12 12 12 24 10 14 10 14 10 14 10 14 14 10 14 13 13 13 13 13 10 14 14 10 10 10 14 10 14 10 10 10 10 14 14 10 23 12 12 12 12 12 12 12 12
12 12 12 12 12 29 12 12 24 10 14 10 14 10 14 10 14 14 10 14 13 13 13 13 13 16 14 14 10 14 14 14 10 14 10 14 14 14 14 14 10 23 12 12 12 12 12 12 12 12
12 12 12 12 12 12 12 12 24 10 14 10 10 10 14 10 10 14 10 14 13 13 13 13 13 10 14 14 10 14 10 10 16 14 10 14 10 14 10 14 10 23 12 12 12 12 12 12 12 12
12 12 12 12 12 12 12 12 24 10 14 14 14 14 14 14 10 14 10 14 13 13 13 13 13 10 14 10 10 14 14 14 10 14 10 10 10 10 10 14 10 23 12 12 12 12 12 12 12 12
12 12 12 12 12 12 12 29 24 10 14 10 10 10 10 10 10 10 10 14 13 13 13 13 13 16 14 10 14 14 14 14 10 14 10 14 14 14 14 14 10 23 12 12 12 12 12 12 12 12
12 12 12 12 12 12 12 12 24 10 14 10 14 14 14 14 14 14 14 14 13 13 13 13 13 10 14 10 10 10 10 10 10 14 10 14 10 10 10 14 10 23 12 12 12 12 12 12 12 12
12 12 12 12 12 12 12 12 24 10 14 10 14 14 14 14 14 14 14 14 13 13 13 13 13 10 14 14 14 14 14 14 10 14 10 10 10 14 10 14 10 23 12 12 29 12 12 12 12 12
12 12 12 12 12 12 12 12 24 16 14 10 14 10 10 10 10 10 10 14 13 13 13 13 13 10 10 10 10 10 10 16 10 14 14 14 14 14 10 14 10 23 12 12 12 12 12 12 12 12
12 12 12 12 12 12 12 12 24 10 14 10 10 10 14 10 14 14 10 14 13 13 13 13 13 14 14 14 14 14 14 14 10 14 10 10 10 10 10 10 10 23 12 12 12 12 12 12 12 12
12 12 12 12 12 12 12 12 24 10 14 14 14 14 14 10 14 14 10 14 13 13 13 13 13 14 10 14 10 10 10 14 10 14 10 14 14 14 14 14 14 23 12 12 12 12 12 12 12 12
12 12 12 12 12 12 12 12 24 10 14 10 10 16 10 10 14 14 10 14 13 13 13 13 13 14 10 14 10 14 10 14 10 14 10 10 10 10 10 10 10 23 12 29 12 12 12 12 12 12
12 12 12 12 12 29 12 12 24 14 14 14 14 14 14 14 14 14 10 14 13 13 13 13 13 14 10 14 10 14 10 14 10 14 14 14 14 14 14 14 10 23 12 12 12 12 12 12 12 12
12 12 12 12 12 12 12 12 24 10 10 10 10 10 10 10 10 10 10 14 13 13 13 13 13 14 10 10 10 14 10 10 16 10 10 10 10 10 10 14 10 23 12 12 12 12 12 12 12 12
12 12 12 12 12 12 12 12 26 17 17 17 17 17 17 17 17 17 17 17 17 17 17 17 17 17 17 17 17 17 17 17 17 17 17 17 17 17 17 17 17 25 12 12 12 12 12 12 12 12
12 12 12 12 12 12 12 12 12 12 12 29 12 12 12 12 12 12 12 12 12 12 12 12 12 12 12 12 12 12 12 12 12 12 12 12 12 12 12 12 12 12 12 12 12 12 12 12 12 12
12 12 12 12 12 12 12 29 12 12 12 12 12 12 12 12 12 12 12 12 12 29 12 12 12 12 12 12 12 12 29 12 12 12 12 12 12 12 12 12 12 12 29 12 12 12 12 12 12 12
12 12 12 12 12 12 12 12 12 12 12 12 12 29 12 12 12 12 12 12 12 12 12 12 12 12 12 12 12 12 12 12 12 12 12 12 12 12 12 12 12 12 12 12 12 12 12 12 12 12
12 12 12 12 12 12 12 12 12 12 12 12 12 12 12 12 12 12 12 12 12 12 12 12 12 12 12 12 29 12 12 12 12 12 12 12 12 12 12 12 12 12 12 12 12 12 12 12 12 12
12 12 12 12 12 12 12 12 12 12 12 12 12 12 12 12 12 12 12 12 12 12 12 12 12 12 12 12 12 12 12 12 12 12 12 12 12 12 12 12 12 12 12 12 12 12 12 12 12 12
12 12 12 12 12 12 12 12 12 12 12 12 12 12 12 12 12 12 12 12 12 12 12 12 12 12 12 12 12 12 12 12 12 12 12 12 12 12 12 12 12 12 12 12 12 12 12 12 12 12
12 12 12 12 12 12 12 12 12 12 12 12 12 12 12 12 12 12 12 12 12 12 12 12 12 12 12 12 12 12 12 12 12 12 12 12 12 12 12 12 12 12 12 12 12 12 12 12 12 12
12 12 12 12 12 12 12 12 12 12 12 12 12 12 12 12 12 12 12 12 12 12 12 12 12 12 12 12 12 12 12 12 12 12 12 12 12 12 12 12 12 12 12 12 12 12 12 12 12 12