12 12 12 12 12 12 12 12 12 12 12 12 12 12 12 12 12 12 12 12 12 12 12 12 12 12 12 12 12 12 12 12 12 12 12 12 12 12 12 12 12 12 12 12 12 12 12 12 12 12
12 12 12 12 12 12 12 12 12 12 12 12 12 12 12 12 12 12 12 12 12 12 12 12 12 12 12 12 12 12 12 12 12 12 12 12 12 12 12 12 12 12 12 12 12 12 12 12 12 12
12 12 12 12 12 12 12 12 12 12 12 12 12 12 12 12 12 12 12 12 12 12 12 12 12 12 12 12 12 12 12 12 12 12 12 12 12 12 12 12 12 12 12 12 12 12 12 12 12 12
12 12 12 12 12 12 12 12 12 12 12 12 12 12 12 12 12 12 12 12 12 12 12 12 12 12 12 12 12 12 12 12 12 12 12 12 12 12 12 12 12 12 12 12 12 12 12 12 12 12
12 12 12 12 12 12 12 12 12 12 12 12 12 12 12 12 12 12 12 12 12 12 12 12 12 12 12 12 12 12 12 12 12 12 12 12 12 12 12 12 12 12 12 12 12 12 12 12 12 12
12 12 12 12 12 12 12 12 12 12 12 12 12 12 12 29 12 12 12 12 12 29 12 12 12 12 12 12 12 12 12 12 12 12 12 12 12 12 12 12 12 12 12 12 12 12 12 12 12 12
12 12 12 12 12 29 12 12 12 12 12 12 12 12 12 12 12 29 12 12 12 12 12 12 12 12 12 12 12 12 12 12 12 12 12 12 12 29 12 12 12 12 12 12 12 12 12 12 12 12
12 12 12 12 12 12 12 29 12 12 12 12 12 12 12 12 12 12 12 12 12 12 12 12 12 12 12 12 12 12 12 12 12 12 12 12 12 12 12 12 12 12 29 12 12 12 12 12 12 12
12 12 12 12 12 12 12 12 28 20 20 20 20 20 20 20 20 20 20 20 20 20 20 20 20 20 20 20 20 20 20 20 20 20 20 20 20 20 20 20 20 27 12 12 12 12 12 12 12 12
12 12 12 12 12 12 12 12 24 10 10 10 16 10 10 10 10 10 10 10 10 10 10 10 14 10 10 14 14 14 14 14 10 14 14 14 10 16 10 10 14 23 12 12 12 12 12 12 12 12
12 12 12 12 12 12 12 12 24 10 14 10 14 14 14 14 14 14 14 14 14 14 14 10 10 10 10 10 16 10 10 16 10 14 14 10 10 10 14 10 14 23 12 12 12 29 12 12 12 12
12 12 12 12 12 12 12 29 24 10 14 14 14 14 10 10 10 10 10 16 10 10 14 14 14 14 14 14 14 14 14 10 14 14 14 10 14 14 14 10 14 23 12 12 12 12 12 12 12 12
12 12 12 12 12 12 12 12 24 10 10 14 14 14 10 11 11 11 11 11 11 11 11 11 11 11 11 11 11 11 14 10 14 14 14 10 14 10 14 14 14 23 12 12 12 12 12 12 12 12
12 12 12 12 12 12 12 12 24 14 10 10 10 14 10 11 18 17 17 17 17 17 17 17 17 17 17 17 19 11 14 10 14 14 10 10 10 10 10 14 14 23 29 12 12 12 12 12 12 12
12 12 12 12 12 12 12 12 24 14 10 14 10 14 10 11 23 12 12 28 20 20 20 20 20 27 12 12 24 11 16 10 14 14 10 14 10 14 10 10 14 23 12 12 29 12 12 12 12 12
12 12 12 12 12 12 12 29 24 14 10 14 10 14 10 11 23 12 12 24 40 33 33 33 41 23 12 12 24 11 10 10 14 14 10 14 14 14 14 14 14 23 12 12 12 12 12 12 12 12
12 12 12 29 12 12 12 12 24 14 10 14 10 14 16 11 23 29 12 24 36 13 13 13 37 23 29 12 24 11 10 14 14 14 10 14 10 10 10 10 10 23 12 29 12 12 12 12 12 12
12 12 12 12 12 12 12 12 24 14 10 14 10 14 10 11 23 12 12 24 36 13 13 13 37 23 12 12 24 11 10 14 10 10 10 10 10 10 14 14 10 23 12 12 12 12 12 12 12 12
12 12 12 12 12 12 12 12 24 14 16 14 10 14 10 11 23 12 29 26 19 32 13 31 18 25 12 12 24 11 10 14 10 14 14 14 14 14 14 10 16 23 12 12 12 12 12 12 12 12
12 12 12 12 29 12 12 12 24 14 10 14 10 14 10 11 23 12 12 12 24 36 13 37 23 12 12 29 24 11 10 14 10 14 10 10 10 10 10 10 10 23 12 12 12 12 12 12 12 12
12 12 12 12 12 12 12 12 24 14 10 14 10 14 10 11 21 20 20 20 22 36 13 37 21 20 20 20 22 11 16 14 10 14 10 14 14 14 14 14 10 23 12 29 12 12 12 12 12 12
12 12 12 12 12 12 12 12 24 10 10 14 10 14 10 11 11 11 11 11 11 11 13 11 11 11 11 11 11 11 10 14 10 14 10 10 10 14 10 14 10 23 12 12 12 12 12 12 12 12
12 12 12 12 12 12 12 12 24 10 14 14 10 14 10 10 16 10 10 10 11 11 13 11 11 16 10 10 10 10 10 14 10 14 10 14 10 10 10 14 10 23 12 12 12 12 12 12 12 12
12 12 12 12 12 12 12 12 24 10 14 10 10 14 14 14 14 14 14 16 11 11 13 11 11 10 14 14 14 14 14 14 10 14 10 14 14 14 14 14 16 23 12 12 12 12 12 12 12 12
12 12 12 12 12 12 12 29 24 10 14 10 14 10 14 14 14 10 14 10 11 11 13 11 11 10 14 10 10 10 10 10 10 14 10 10 10 10 10 14 10 23 12 12 12 29 12 12 12 12
12 12 12 12 12 12 12 12 24 10 14 10 14 10 10 10 10 10 14 10 36 13 13 13 37 16 14 10 14 14 14 14 14 14 10 10 14 14 10 14 10 23 12 12 12 12 12 12 12 12
12 12 12 12 12 12 12 12 24 10 14 10 14 14 14 14 14 10 14 14 36 13 13 13 37 10 14 10 10 10 10 14 10 14 14 14 14 10 10 14 10 23 12 12 12 12 12 12 12 12
12 12 12 12 12 12 12 12 24 10 14 16 14 10 16 10 14 16 10 14 36 13 13 13 37 16 14 14 14 14 10 14 10 14 14 10 14 10 14 14 10 23 12 12 12 12 12 12 12 12
12 12 12 12 12 12 12 12 24 16 14 10 14 10 14 16 14 14 10 14 36 13 13 13 37 10 14 14 10 10 10 14 10 14 10 10 10 10 14 14 10 23 12 12 12 12 12 12 12 12
12 12 12 12 12 29 12 12 24 10 14 10 14 10 14 10 14 14 16 14 36 13 13 13 37 16 14 14 10 14 14 14 10 14 10 14 14 14 14 14 10 23 12 12 12 12 12 12 12 12
12 12 12 12 12 12 12 12 24 10 14 10 10 10 14 10 10 14 10 14 36 13 13 13 37 10 14 14 10 14 10 10 16 14 10 14 10 14 10 14 10 23 12 12 12 12 12 12 12 12
12 12 12 12 12 12 12 12 24 10 14 14 14 14 14 14 10 14 10 14 36 13 13 13 37 10 14 10 10 14 14 14 10 14 16 10 10 10 10 14 10 23 12 12 12 12 12 12 12 12
12 12 12 12 12 12 12 29 24 10 14 10 10 10 10 10 10 10 16 14 36 13 13 13 37 16 14 10 14 14 14 14 10 14 10 14 14 14 14 14 16 23 12 12 12 12 12 12 12 12
12 12 12 12 12 12 12 12 24 10 14 10 14 14 14 14 14 14 14 14 36 13 13 13 37 10 14 10 10 10 10 10 10 14 10 14 10 10 10 14 10 23 12 12 12 12 12 12 12 12
12 12 12 12 12 12 12 12 24 10 14 10 14 14 14 14 14 14 14 14 36 13 13 13 37 10 14 14 14 14 14 14 10 14 10 10 10 14 10 14 10 23 12 12 29 12 12 12 12 12
12 12 12 12 12 12 12 12 24 16 14 16 14 10 10 10 16 10 10 14 36 13 13 13 37 10 10 10 10 10 10 16 10 14 14 14 14 14 10 14 10 23 12 12 12 12 12 12 12 12
12 12 12 12 12 12 12 12 24 10 14 10 10 10 14 10 14 14 10 14 36 13 13 13 37 14 14 14 14 14 14 14 10 14 10 16 10 10 10 14 10 23 12 12 12 12 12 12 12 12
12 12 12 12 12 12 12 12 24 10 14 14 14 14 14 10 14 14 10 14 36 13 13 13 37 14 10 14 10 10 10 14 10 14 10 14 14 14 14 14 14 23 12 12 12 12 12 12 12 12
12 12 12 12 12 12 12 12 24 10 14 10 10 16 10 10 14 14 16 14 36 13 13 13 37 14 10 14 10 14 10 14 10 14 10 10 10 10 10 10 10 23 12 29 12 12 12 12 12 12
12 12 12 12 12 29 12 12 24 14 14 14 14 14 14 14 14 14 10 14 36 13 13 13 37 14 10 14 10 14 10 14 10 14 14 14 14 14 14 14 10 23 12 12 12 12 12 12 12 12
12 12 12 12 12 12 12 12 24 10 10 10 10 10 10 16 10 10 10 14 36 13 13 13 37 14 10 10 10 14 10 10 16 10 10 10 10 10 10 14 10 23 12 12 12 12 12 12 12 12
12 12 12 12 12 12 12 12 26 17 17 17 17 17 17 17 17 17 17 17 17 17 17 17 17 17 17 17 17 17 17 17 17 17 17 17 17 17 17 17 17 25 12 12 12 12 12 12 12 12
12 12 12 12 12 12 12 12 12 12 12 29 12 12 12 12 12 12 12 12 12 12 12 12 12 12 12 12 12 12 12 12 12 12 12 12 12 12 12 12 12 12 12 12 12 12 12 12 12 12
12 12 12 12 12 12 12 29 12 12 12 12 12 12 12 12 12 12 12 12 12 29 12 12 12 12 12 12 12 12 29 12 12 12 12 12 12 12 12 12 12 12 29 12 12 12 12 12 12 12
12 12 12 12 12 12 12 12 12 12 12 12 12 29 12 12 12 12 12 12 12 12 12 12 12 12 12 12 12 12 12 12 12 12 12 12 12 12 12 12 12 12 12 12 12 12 12 12 12 12
12 12 12 12 12 12 12 12 12 12 12 12 12 12 12 12 12 12 12 12 12 12 12 12 12 12 12 12 29 12 12 12 12 12 12 12 12 12 12 12 12 12 12 12 12 12 12 12 12 12
12 12 12 12 12 12 12 12 12 12 12 12 12 12 12 12 12 12 12 12 12 12 12 12 12 12 12 12 12 12 12 12 12 12 12 12 12 12 12 12 12 12 12 12 12 12 12 12 12 12
12 12 12 12 12 12 12 12 12 12 12 12 12 12 12 12 12 12 12 12 12 12 12 12 12 12 12 12 12 12 12 12 12 12 12 12 12 12 12 12 12 12 12 12 12 12 12 12 12 12
12 12 12 12 12 12 12 12 12 12 12 12 12 12 12 12 12 12 12 12 12 12 12 12 12 12 12 12 12 12 12 12 12 12 12 12 12 12 12 12 12 12 12 12 12 12 12 12 12 12
12 12 12 12 12 12 12 12 12 12 12 12 12 12 12 12 12 12 12 12 12 12 12 12 12 12 12 12 12 12 12 12 12 12 12 12 12 12 12 12 12 12 12 12 12 12 12 12 12 12